                                                       
                                                       
                                                       
                                                       
                                                       
                                                       
                                                       
                                                       
                                                       
                                                       
                         -   - - - - - - - - - - - -   
                        |X| |XXXXXXXXXXXXXXXXXXXXXXX|  
                         X - - X - X X X X - - X X X   
                        |XX0XXXX|XXXXXXX|XXXXX|XXXXX|  
                         X X - X X - - - - X - - X X   
                        |X|XXX|XXXX1XXXX|XXX|XXXXXXX|  
                         X - - - X - X - - - - X - -   
                        |XXX|XXXXX|XXX|XXX|2XXXXXXXX|  
                         X - - - X - X - - X - - - -   
                        |XXXXXXXXXXX|XXXXXXX|          
                         X X X X - - X - - X         - 
                        |X|X|XXXXXXXXXXXXXXX|       |X|
                         - - - - - - - - - -   - - - X 
                                |XXXXX|       |XXXXXXX|
                           - - - - X - - - - - - X X X 
                          |XXXXXXXXXXXXXXXXXXXXXXXXXXX|
                           - - - - - - - - - - - - - - 
